vn_genome_ids,c00,c10,c01,c11,c1s,c_sum
HG02513,42,15,0,1,16,58
HG02138,37,7,11,3,21,58
HG02075,40,4,11,3,18,58
HG02031,37,13,5,3,21,58
HG02084,50,7,0,1,8,58
HG02047,39,1,4,14,19,58
HG01597,57,0,0,1,1,58
HG01849,40,1,1,16,18,58
HG02023,57,0,0,1,1,58
HG01846,41,16,0,1,17,58
HG02081,43,14,0,1,15,58
HG01599,43,0,14,1,15,58
HG01866,39,0,18,1,19,58
HG02064,43,14,0,1,15,58
HG02069,43,0,14,1,15,58
HG02087,48,8,0,2,10,58
HG02017,43,14,0,1,15,58
HG01864,57,0,0,1,1,58
HG01868,37,6,11,4,21,58
HG01596,51,6,0,1,7,58
HG02072,48,0,9,1,10,58
HG02079,40,13,4,1,18,58
HG01600,44,0,13,1,14,58
HG02140,42,0,15,1,16,58
HG01841,40,4,0,14,18,58
HG02020,40,4,11,3,18,58
HG01878,40,0,17,1,18,58
HG02085,41,0,1,16,17,58
HG01598,41,16,0,1,17,58
HG01872,40,3,14,1,18,58
HG02073,41,0,16,1,17,58
HG01845,41,3,1,13,17,58
HG02032,42,0,15,1,16,58
HG02088,36,12,7,3,22,58
HG01840,43,0,14,1,15,58
HG01855,42,1,1,14,16,58
HG02050,42,0,2,14,16,58
HG01844,43,0,14,1,15,58
HG02067,43,13,1,1,15,58
HG02133,42,0,15,1,16,58
HG02127,40,0,17,1,18,58
HG02512,44,0,13,1,14,58
HG02040,44,0,0,14,14,58
HG01859,42,0,12,4,16,58
HG02078,57,0,0,1,1,58
HG02070,57,0,0,1,1,58
HG02029,37,11,5,5,21,58
HG02116,43,0,14,1,15,58
HG01842,43,0,3,12,15,58
HG01867,39,0,5,14,19,58
HG02060,43,14,0,1,15,58
HG01843,42,0,2,14,16,58
HG02028,43,0,1,14,15,58
HG01861,43,14,0,1,15,58
HG01869,47,0,10,1,11,58
HG01865,45,1,9,3,13,58
HG01848,52,5,0,1,6,58
HG02048,44,13,0,1,14,58
HG02130,42,15,0,1,16,58
HG01595,42,15,0,1,16,58
HG01860,47,1,3,7,11,58
HG01853,43,0,14,1,15,58
HG02139,39,1,17,1,19,58
HG02121,57,0,0,1,1,58
HG01858,39,4,12,3,19,58
HG02058,41,0,16,1,17,58
HG02076,40,0,7,11,18,58
HG02131,44,13,0,1,14,58
HG02522,56,0,1,1,2,58
HG02019,44,0,13,1,14,58
HG01851,47,0,10,1,11,58
HG02016,42,12,2,2,16,58
HG01874,41,0,0,17,17,58
HG02057,57,0,0,1,1,58
HG02521,48,0,9,1,10,58
HG02035,49,8,0,1,9,58
HG02025,47,1,9,1,11,58
HG02128,56,1,0,1,2,58
HG01862,57,0,0,1,1,58
HG02134,40,3,1,14,18,58
HG02082,46,0,11,1,12,58
HG02122,41,16,0,1,17,58
HG01870,40,17,0,1,18,58
HG02136,47,0,10,1,11,58
HG01852,42,2,13,1,16,58
HG02137,41,0,3,14,17,58
HG01850,41,2,0,15,17,58
HG01857,41,3,0,14,17,58
HG02061,44,0,13,1,14,58
HG02142,42,5,1,10,16,58
HG01863,41,3,0,14,17,58
HG02026,57,0,0,1,1,58
HG01871,55,2,0,1,3,58
HG02141,31,8,15,4,27,58
HG01873,57,0,0,1,1,58
HG02049,48,0,8,2,10,58
HG02086,56,1,0,1,2,58
HG02113,43,14,0,1,15,58
HG01847,39,11,4,4,19,58
