vn_genomes,c00,c10,c01,c11,c1s,c_sum
HG02513,45,1,6,10,17,62
HG02138,48,2,2,10,14,62
HG02075,45,3,11,3,17,62
HG02031,45,5,2,10,17,62
HG02084,45,1,3,13,17,62
HG02047,44,7,1,10,18,62
HG01597,47,2,3,10,15,62
HG01849,48,3,1,10,14,62
HG02023,45,3,4,10,17,62
HG01846,44,2,6,10,18,62
HG02081,44,7,1,10,18,62
HG01599,44,11,2,5,18,62
HG01866,48,2,1,11,14,62
HG02064,35,15,7,5,27,62
HG02069,45,3,4,10,17,62
HG02087,42,7,3,10,20,62
HG02017,44,2,5,11,18,62
HG01864,45,2,3,12,17,62
HG01868,45,1,6,10,17,62
HG01596,46,0,2,14,16,62
HG02072,45,5,10,2,17,62
HG02079,44,7,2,9,18,62
HG01600,37,8,12,5,25,62
HG02140,47,1,4,10,15,62
HG01841,45,3,1,13,17,62
HG02020,44,6,1,11,18,62
HG01878,37,15,5,5,25,62
HG02085,34,12,8,8,28,62
HG01598,44,6,1,11,18,62
HG01872,45,0,7,10,17,62
HG02073,44,3,5,10,18,62
HG01845,44,3,2,13,18,62
HG02032,40,5,5,12,22,62
HG02088,45,6,0,11,17,62
HG01840,48,1,4,9,14,62
HG01855,45,3,3,11,17,62
HG02050,45,0,7,10,17,62
HG01844,44,10,4,4,18,62
HG02067,36,9,10,7,26,62
HG02133,48,3,10,1,14,62
HG02127,44,1,4,13,18,62
HG02512,44,2,4,12,18,62
HG02040,45,1,2,14,17,62
HG01859,45,5,2,10,17,62
HG02078,43,5,2,12,19,62
HG02070,45,1,3,13,17,62
HG02029,45,0,4,13,17,62
HG02116,44,2,5,11,18,62
HG01842,37,7,11,7,25,62
HG01867,45,4,0,13,17,62
HG02060,46,2,4,10,16,62
HG01843,45,4,3,10,17,62
HG02028,45,1,6,10,17,62
HG01861,36,8,10,8,26,62
HG01869,47,3,2,10,15,62
HG01865,48,1,3,10,14,62
HG01848,36,14,7,5,26,62
HG02048,44,1,4,13,18,62
HG02130,45,2,1,14,17,62
HG01595,44,3,2,13,18,62
HG01860,48,0,3,11,14,62
HG01853,44,2,4,12,18,62
HG02139,44,5,2,11,18,62
HG02121,42,6,3,11,20,62
HG01858,46,3,3,10,16,62
HG02058,44,10,6,2,18,62
HG02076,37,5,15,5,25,62
HG02131,47,2,3,10,15,62
HG02522,36,13,8,5,26,62
HG02019,46,2,13,1,16,62
HG01851,45,1,2,14,17,62
HG02016,34,12,9,7,28,62
HG01874,39,13,5,5,23,62
HG02057,43,5,0,14,19,62
HG02521,44,1,4,13,18,62
HG02035,45,1,14,2,17,62
HG02025,45,6,1,10,17,62
HG02128,44,1,5,12,18,62
HG01862,45,0,7,10,17,62
HG02134,43,9,0,10,19,62
HG02082,44,10,7,1,18,62
HG02122,37,13,7,5,25,62
HG01870,47,4,9,2,15,62
HG02136,43,2,15,2,19,62
HG01852,42,5,1,14,20,62
HG02137,43,9,5,5,19,62
HG01850,49,2,1,10,13,62
HG01857,44,1,4,13,18,62
HG02061,46,0,6,10,16,62
HG02142,44,1,4,13,18,62
HG01863,46,3,2,11,16,62
HG02026,42,9,1,10,20,62
HG01871,46,4,1,11,16,62
HG02141,42,6,3,11,20,62
HG01873,42,2,7,11,20,62
HG02049,43,8,1,10,19,62
HG02086,46,4,2,10,16,62
HG02113,46,13,1,2,16,62
HG01847,45,2,4,11,17,62
