vn_genome_ids,c00,c01,c10,c11,c1s,c_sum
HG02513,53,3,2,0,5,58
HG02138,56,0,2,0,2,58
HG02075,56,0,2,0,2,58
HG02031,58,0,0,0,0,58
HG02084,54,2,2,0,4,58
HG02047,56,2,0,0,2,58
HG01597,58,0,0,0,0,58
HG01849,53,3,2,0,5,58
HG02023,56,1,1,0,2,58
HG01846,57,1,0,0,1,58
HG02081,54,1,3,0,4,58
HG01599,53,0,5,0,5,58
HG01866,58,0,0,0,0,58
HG02064,54,0,4,0,4,58
HG02069,58,0,0,0,0,58
HG02087,56,2,0,0,2,58
HG02017,57,0,1,0,1,58
HG01864,55,3,0,0,3,58
HG01868,55,3,0,0,3,58
HG01596,54,2,2,0,4,58
HG02072,57,0,1,0,1,58
HG02079,56,0,2,0,2,58
HG01600,56,1,1,0,2,58
HG02140,57,0,0,1,1,58
HG01841,56,2,0,0,2,58
HG02020,55,2,0,1,3,58
HG01878,57,1,0,0,1,58
HG02085,56,0,2,0,2,58
HG01598,56,0,2,0,2,58
HG01872,53,1,4,0,5,58
HG02073,54,4,0,0,4,58
HG01845,55,2,0,1,3,58
HG02032,53,2,3,0,5,58
HG02088,55,3,0,0,3,58
HG01840,57,1,0,0,1,58
HG01855,56,2,0,0,2,58
HG02050,56,0,2,0,2,58
HG01844,54,4,0,0,4,58
HG02067,54,1,3,0,4,58
HG02133,54,0,4,0,4,58
HG02127,56,1,1,0,2,58
HG02512,57,1,0,0,1,58
HG02040,55,0,3,0,3,58
HG01859,54,1,3,0,4,58
HG02078,56,2,0,0,2,58
HG02070,58,0,0,0,0,58
HG02029,57,1,0,0,1,58
HG02116,54,2,2,0,4,58
HG01842,55,3,0,0,3,58
HG01867,57,1,0,0,1,58
HG02060,57,0,1,0,1,58
HG01843,58,0,0,0,0,58
HG02028,56,2,0,0,2,58
HG01861,52,3,3,0,6,58
HG01869,55,0,0,3,3,58
HG01865,57,0,0,1,1,58
HG01848,55,3,0,0,3,58
HG02048,52,3,3,0,6,58
HG02130,57,0,1,0,1,58
HG01595,53,3,1,1,5,58
HG01860,54,3,1,0,4,58
HG01853,54,3,1,0,4,58
HG02139,55,2,1,0,3,58
HG02121,58,0,0,0,0,58
HG01858,55,2,1,0,3,58
HG02058,57,0,1,0,1,58
HG02076,54,3,1,0,4,58
HG02131,57,0,0,1,1,58
HG02522,55,0,3,0,3,58
HG02019,58,0,0,0,0,58
HG01851,58,0,0,0,0,58
HG02016,57,0,1,0,1,58
HG01874,55,1,2,0,3,58
HG02057,54,2,2,0,4,58
HG02521,58,0,0,0,0,58
HG02035,56,0,0,2,2,58
HG02025,55,1,1,1,3,58
HG02128,53,0,5,0,5,58
HG01862,58,0,0,0,0,58
HG02134,56,0,0,2,2,58
HG02082,56,0,2,0,2,58
HG02122,55,2,1,0,3,58
HG01870,56,2,0,0,2,58
HG02136,56,0,2,0,2,58
HG01852,54,1,3,0,4,58
HG02137,56,0,2,0,2,58
HG01850,56,2,0,0,2,58
HG01857,55,2,1,0,3,58
HG02061,56,0,2,0,2,58
HG02142,52,3,3,0,6,58
HG01863,55,3,0,0,3,58
HG02026,55,2,1,0,3,58
HG01871,57,1,0,0,1,58
HG02141,58,0,0,0,0,58
HG01873,58,0,0,0,0,58
HG02049,58,0,0,0,0,58
HG02086,56,0,2,0,2,58
HG02113,56,0,2,0,2,58
HG01847,54,1,2,1,4,58
