vn_genome_ids,c00,c01,c10,c11,c1s,c_sum
HG02513,88,1,3,0,4,92
HG02138,82,2,8,0,10,92
HG02075,78,5,9,0,14,92
HG02031,90,1,1,0,2,92
HG02084,86,4,2,0,6,92
HG02047,79,5,8,0,13,92
HG01597,85,6,1,0,7,92
HG01849,84,2,6,0,8,92
HG02023,85,1,6,0,7,92
HG01846,83,1,8,0,9,92
HG02081,83,3,6,0,9,92
HG01599,88,1,3,0,4,92
HG01866,85,5,2,0,7,92
HG02064,80,4,8,0,12,92
HG02069,81,3,8,0,11,92
HG02087,85,2,5,0,7,92
HG02017,83,4,5,0,9,92
HG01864,81,2,9,0,11,92
HG01868,89,1,2,0,3,92
HG01596,84,5,3,0,8,92
HG02072,79,4,1,8,13,92
HG02079,83,9,0,0,9,92
HG01600,81,8,3,0,11,92
HG02140,80,3,9,0,12,92
HG01841,85,6,1,0,7,92
HG02020,85,2,5,0,7,92
HG01878,84,0,0,8,8,92
HG02085,82,1,9,0,10,92
HG01598,81,8,3,0,11,92
HG01872,84,4,4,0,8,92
HG02073,79,6,7,0,13,92
HG01845,82,2,8,0,10,92
HG02032,78,8,6,0,14,92
HG02088,87,2,3,0,5,92
HG01840,90,0,0,2,2,92
HG01855,82,2,8,0,10,92
HG02050,82,2,8,0,10,92
HG01844,82,7,3,0,10,92
HG02067,83,7,2,0,9,92
HG02133,78,10,4,0,14,92
HG02127,84,0,8,0,8,92
HG02512,85,1,6,0,7,92
HG02040,88,4,0,0,4,92
HG01859,87,3,2,0,5,92
HG02078,88,3,1,0,4,92
HG02070,82,2,8,0,10,92
HG02029,90,1,0,1,2,92
HG02116,88,0,4,0,4,92
HG01842,83,8,1,0,9,92
HG01867,87,2,1,2,5,92
HG02060,83,3,2,4,9,92
HG01843,90,1,1,0,2,92
HG02028,79,9,4,0,13,92
HG01861,83,9,0,0,9,92
HG01869,79,9,4,0,13,92
HG01865,82,3,7,0,10,92
HG01848,81,8,3,0,11,92
HG02048,82,0,2,8,10,92
HG02130,89,2,0,1,3,92
HG01595,88,3,1,0,4,92
HG01860,88,1,0,3,4,92
HG01853,83,2,7,0,9,92
HG02139,83,8,1,0,9,92
HG02121,81,8,3,0,11,92
HG01858,87,0,1,4,5,92
HG02058,83,7,2,0,9,92
HG02076,79,8,5,0,13,92
HG02131,74,6,12,0,18,92
HG02522,86,2,4,0,6,92
HG02019,80,4,8,0,12,92
HG01851,85,0,7,0,7,92
HG02016,87,2,3,0,5,92
HG01874,83,0,9,0,9,92
HG02057,84,2,6,0,8,92
HG02521,85,1,6,0,7,92
HG02035,80,8,4,0,12,92
HG02025,88,2,2,0,4,92
HG02128,84,2,6,0,8,92
HG01862,85,1,6,0,7,92
HG02134,79,8,5,0,13,92
HG02082,80,8,4,0,12,92
HG02122,79,5,8,0,13,92
HG01870,87,4,1,0,5,92
HG02136,83,0,9,0,9,92
HG01852,84,2,6,0,8,92
HG02137,82,2,8,0,10,92
HG01850,82,5,5,0,10,92
HG01857,84,0,8,0,8,92
HG02061,85,1,6,0,7,92
HG02142,81,8,3,0,11,92
HG01863,83,6,3,0,9,92
HG02026,86,0,2,4,6,92
HG01871,83,0,1,8,9,92
HG02141,84,0,0,8,8,92
HG01873,78,9,5,0,14,92
HG02049,81,9,2,0,11,92
HG02086,81,2,9,0,11,92
HG02113,84,3,5,0,8,92
HG01847,84,2,6,0,8,92
